3333022033333
3333022033333
3333020033333
3333300333333
3333302333333
3333300333333
3333320333333
3333300333333
3333302333333
3333300333333
