0221144411200
0221144411200
0221134411200
0221143311200
0221143411200
0221143411200
0221143411200
0221143411200
0221143311200
0221134411200
