1111111111111
1111111111111
4111111111114
4011111111104
4001111111004
4000111110004
4000011100004
4000001000004
4000002000004
3333302033333
