2222000001111
2220000000111
2200004000011
2000041400001
0000411140000
0000041400000
4000004000003
4400000000033
4440000000333
4444000003333
