0000001000000
0010001000100
0031001001300
0033100013300
0030301030300
0030301030300
0030301030300
0030301030300
0030311130300
0033333333300
