1003333333001
1030222220301
4444244424444
4100201020014
4100201020014
4133231323314
4100200020014
4100203020014
4130200020014
2222200022222
