0000000000000
0000000000000
0000000000000
0005555500000
0000000000001
0006666000000
0007777000000
0000880000000
0000000000000
0000000000000
