0022011108800
0022011108800
0022011108800
0022011108800
0000000000000
0000000000000
2200011100088
2200011100088
2200011100088
2200011100088
