0000000000000
0000022222000
0001023332100
0000123332010
0001123332011
0011123332111
0011123332111
0001123332011
0000123332010
0001022222100
