3100000000000
3310000000000
3331000000000
3333100000000
3333310000000
3333331000000
3333333100000
3333333310000
3333333331000
3333333333100
