0333333333300
0303333333030
3000111110003
0300111110030
0033113113300
0000113110000
0000111110000
2222111112222
2222000002222
2222000002222
