0000000000000
0000000000000
0888888000000
0877778000000
0876678500000
0876678555555
0876678500000
0877778000000
0888888000000
0000000000000
