3000000000000
3010000000000
3301000000000
3330100000000
3333010000000
3333301000000
3333330100000
3333333010000
3333333301111
3333333330000
