0000000000000
0000000000000
0000000000000
1234567800000
0000000000001
0000000000000
0000000000000
0000000000000
0000000000000
0000000000000
