0888066077700
0888066077700
0888066077700
0888066077700
0888066077700
0000000000000
0000000000000
0000000000000
0000000000000
4444444444444
