3111111111113
3111111111113
3111111111113
3311111111133
3331111111333
3333111113333
3333331333333
3333331333333
3333331333333
3333331333333
