0000000000000
0008888888000
0008007008000
0008077708000
0008077708000
0008077708000
8888077708888
0005555555000
0000666660000
0000066600000
