2222222222222
2200001000022
2000011100002
2000111110002
2001111111002
2000111110002
2000011100002
2000001000002
2200000000022
2222222222222
