3333333333333
3330000000333
3333333333333
0003333333000
0000333330000
0000033300000
0880003000880
0880000000880
0888888888888
0888888888888
